#############
#     X    O#
#O        ###
####   P  #
   #X     #######
   #     X##    ###
#######           #
# O   #   X  # OO #
#     X      ######
####     #####
   ####### 
